W###################W
W#........#........#W
W#o##.###.#.###.##o#W
W#.................#W
W#.##.#.#####.#.##.#W
W#....#...#...#....#W
W####.###W#W###.####W
WWWW#.#WWW0WWW#.#WWWW
#####.#W##=##W#.#####
WWWWW.WW#123#WW.WWWWW
#####.#W#####W#.#####
WWWW#.#WWWWWWW#.#WWWW
W####.#W#####W#.####W
W#........#........#W
W#.##.###.#.###.##.#W
W#o.#.....P.....#.o#W
W##.#.#.#####.#.#.##W
W#....#...#...#....#W
W#.######.#.######.#W
W#.................#W
W###################W