W###################W
W#....#.......#....#W
W#o##.#.#####.#.##o#W
W#..#.....#.....#..#W
###.#.#W#.#.#W#.#.###
WWW...#W#...#W#...WWW
###.#.#W#####W#.#.###
W#..#.WWWW0WWWW.#..#W
W#.##.#W##=##W#.##.#W
W#....#W#123#W#....#W
W##.###W#####W###.##W
W#....#WWWWWWW#....#W
W#.##.#.#####.#.##.#W
W#..#.#...#...#.#..#W
###.#.#.#.#.#.#.#.###
WWW.....#.P.#.....WWW
###.#.###.#.###.#.###
W#..#.....#.....#..#W
W#o##.#.#####.#.##o#W
W#....#.......#....#W
W###################W